111111111111111111111111111111111
1C0000000000000CC0000000000N000C1
100001100011111001111101111100001
100010100000001000000100000100001
1C00001000111110011111000010000C1
1C0000100000001000CCC100010000C01
10000010000000100CCEC100100000001
1000111110111110011111010000N0001
1C000000000N000CC00N00000000000P1
111111111111111111111111111111111