111111111111111111111111111111111
1C0000000000000CC00000000000000C1
100001100011111001111101111100001
100010100000001000000100000100001
1C00001000111110011111000010000C1
1C00001000000010000CC100110000C11
10000010000000100C0EC100100000001
100011111011111001111101000000001
1C0000000000000CC00000000000000P1
111111111111111111111111111111111